bct 0 0 0 0 0 0 0 0 0
bct 0 1 0 0 2 0 0 0 0
bct 0 2 0 1 0 0 0 0 0
bct 0 3 0 1 0 0 1 0 0
bct 0 4 0 1 0 0 0 0 0
bct 0 5 2 0 0 0 0 0 1
bct 0 6 0 0 0 0 0 0 0
bct 0 7 2 0 0 0 0 0 0
bct 0 8 1 0 0 0 0 0 0
bct 0 9 0 0 0 0 0 0 0
bct 1 0 0 0 0 0 0 0 2
bct 1 1 0 1 0 0 0 0 0
bct 1 2 0 0 1 0 0 0 0
bct 1 3 1 0 0 0 0 0 0
bct 1 4 1 1 0 0 0 0 0
bct 1 5 2 0 0 1 1 0 0
bct 1 6 0 1 1 0 0 0 0
bct 1 7 0 0 0 0 0 0 0
bct 1 8 2 1 0 0 0 0 0
bct 1 9 0 2 3 1 0 0 0
bct 2 0 1 0 0 0 0 0 0
bct 2 1 0 0 0 0 0 0 0
bct 2 2 0 0 0 0 0 0 0
bct 2 3 1 1 0 0 0 0 0
bct 2 4 2 1 1 0 0 0 0
bct 2 5 0 0 0 0 0 0 0
bct 2 6 1 1 0 0 0 0 0
bct 2 7 2 0 0 0 0 0 0
bct 2 8 0 0 0 0 0 0 0
bct 2 9 0 0 0 0 0 0 0
bct 3 0 0 1 0 0 0 0 0
bct 3 1 0 0 0 0 0 0 0
bct 3 2 1 0 0 0 0 0 1
bct 3 3 0 0 0 0 0 0 0
bct 3 4 0 0 0 0 0 0 0
bct 3 5 0 0 0 0 0 0 0
bct 3 6 0 0 0 0 0 0 0
bct 3 7 0 0 0 0 0 1 0
bct 3 8 1 0 0 0 0 0 0
bct 3 9 1 0 0 0 0 0 0
bct 4 0 0 0 0 0 0 0 0
bct 4 1 1 0 0 0 0 0 0
bct 4 2 1 0 0 0 0 0 0
bct 4 3 0 1 0 0 0 0 0
bct 4 4 1 1 0 0 0 0 0
bct 4 5 0 0 1 0 0 0 0
bct 4 6 0 0 0 0 0 0 0
bct 4 7 2 0 0 0 1 0 0
bct 4 8 1 0 0 0 0 0 0
bct 4 9 0 1 0 0 1 0 0
bct 5 0 2 0 0 0 0 0 1
bct 5 1 0 0 0 0 0 0 0
bct 5 2 0 0 0 0 0 1 0
bct 5 3 0 1 0 1 0 0 0
bct 5 4 0 0 0 0 0 0 0
bct 5 5 0 0 0 0 0 0 0
bct 5 6 0 0 0 1 0 0 0
bct 5 7 0 2 0 0 0 0 0
bct 5 8 0 0 0 1 0 0 0
bct 5 9 1 0 0 0 0 0 0
bct 6 0 0 0 1 0 0 0 0
bct 6 1 1 0 0 0 0 0 0
bct 6 2 1 0 0 0 0 1 0
bct 6 3 0 0 0 0 0 0 0
bct 6 4 1 0 0 0 0 1 0
bct 6 5 0 0 0 0 0 0 0
bct 6 6 1 0 0 0 0 0 0
bct 6 7 0 0 0 2 0 0 0
bct 6 8 0 0 1 0 1 0 0
bct 6 9 0 0 0 0 0 0 0
bct 7 0 1 0 0 0 0 0 0
bct 7 1 0 0 0 0 0 0 0
bct 7 2 0 1 1 0 0 0 0
bct 7 3 0 0 0 0 0 0 0
bct 7 4 2 0 0 0 1 0 0
bct 7 5 0 0 0 0 1 0 0
bct 7 6 1 1 0 0 0 1 0
bct 7 7 1 0 0 0 0 0 0
bct 7 8 0 0 0 0 0 1 0
bct 7 9 0 0 0 0 0 0 0
bct 8 0 0 0 0 0 0 0 0
bct 8 1 0 0 0 0 1 0 0
bct 8 2 1 2 1 0 0 0 0
bct 8 3 0 0 0 0 0 0 0
bct 8 4 0 2 0 1 0 1 0
bct 8 5 0 0 0 0 0 0 0
bct 8 6 0 2 0 0 0 0 0
bct 8 7 0 0 0 0 0 0 0
bct 8 8 1 0 0 0 0 0 0
bct 8 9 0 0 0 0 0 0 0
bct 9 0 1 0 0 0 1 0 0
bct 9 1 0 0 1 0 0 0 0
bct 9 2 1 0 0 1 0 0 0
bct 9 3 2 0 1 0 1 1 0
bct 9 4 1 2 0 1 0 0 0
bct 9 5 1 0 0 0 0 0 0
bct 9 6 2 1 0 0 0 0 0
bct 9 7 1 0 0 0 0 0 0
bct 9 8 0 0 0 0 0 0 0
bct 9 9 0 0 0 0 0 0 0
//////////////////////
bct 0 0 0 0 0 0 0 0 0
bct 0 1 0 0 2 0 0 0 0
bct 0 2 0 1 0 0 0 0 0
bct 0 3 0 1 0 0 1 0 0
bct 0 4 0 1 0 0 0 0 0
bct 0 5 2 0 0 0 0 0 1
bct 0 6 0 0 0 0 0 0 0
bct 0 7 2 0 0 0 0 0 0
bct 0 8 1 0 0 0 0 0 0
bct 0 9 0 0 0 0 0 0 0
bct 1 0 0 0 0 0 0 0 2
bct 1 1 0 1 0 0 0 0 0
bct 1 2 0 0 1 0 0 0 0
bct 1 3 1 0 0 0 0 0 0
bct 1 4 1 1 0 0 0 0 0
bct 1 5 2 0 0 1 1 0 0
bct 1 6 0 1 1 0 0 0 0
bct 1 7 0 0 0 0 0 0 0
bct 1 8 2 1 0 0 0 0 0
bct 1 9 0 2 3 1 0 0 0
bct 2 0 1 0 0 0 0 0 0
bct 2 1 0 0 0 0 0 0 0
bct 2 2 0 0 0 0 0 0 0
bct 2 3 1 1 0 0 0 0 0
bct 2 4 2 1 1 0 0 0 0
bct 2 5 0 0 0 0 0 0 0
bct 2 6 1 1 0 0 0 0 0
bct 2 7 2 0 0 0 0 0 0
bct 2 8 0 0 0 0 0 0 0
bct 2 9 0 0 0 0 0 0 0
bct 3 0 0 1 0 0 0 0 0
bct 3 1 0 0 0 0 0 0 0
bct 3 2 1 0 0 0 0 0 1
bct 3 3 0 0 0 0 0 0 0
bct 3 4 0 0 0 0 0 0 0
bct 3 5 0 0 0 0 0 0 0
bct 3 6 0 0 0 0 0 0 0
bct 3 7 0 0 0 0 0 1 0
bct 3 8 1 0 0 0 0 0 0
bct 3 9 1 0 0 0 0 0 0
bct 4 0 0 0 0 0 0 0 0
bct 4 1 1 0 0 0 0 0 0
bct 4 2 1 0 0 0 0 0 0
bct 4 3 0 1 0 0 0 0 0
bct 4 4 1 1 0 0 0 0 0
bct 4 5 0 0 1 0 0 0 0
bct 4 6 0 0 0 0 0 0 0
bct 4 7 2 0 0 0 1 0 0
bct 4 8 1 0 0 0 0 0 0
bct 4 9 0 1 0 0 1 0 0
bct 5 0 2 0 0 0 0 0 1
bct 5 1 0 0 0 0 0 0 0
bct 5 2 0 0 0 0 0 1 0
bct 5 3 0 1 0 1 0 0 0
bct 5 4 0 0 0 0 0 0 0
bct 5 5 0 0 0 0 0 0 0
bct 5 6 0 0 0 1 0 0 0
bct 5 7 0 0 0 0 0 0 0
bct 5 8 0 0 0 1 0 0 0
bct 5 9 1 0 0 0 0 0 0
bct 6 0 0 0 1 0 0 0 0
bct 6 1 1 0 0 0 0 0 0
bct 6 2 1 0 0 0 0 1 0
bct 6 3 0 0 0 0 0 0 0
bct 6 4 1 0 0 0 0 1 0
bct 6 5 0 0 0 0 0 0 0
bct 6 6 1 0 0 0 0 0 0
bct 6 7 0 0 0 2 0 0 0
bct 6 8 0 0 1 0 1 0 0
bct 6 9 0 0 0 0 0 0 0
bct 7 0 1 0 0 0 0 0 0
bct 7 1 0 0 0 0 0 0 0
bct 7 2 0 1 1 0 0 0 0
bct 7 3 0 0 0 0 0 0 0
bct 7 4 2 0 0 0 1 0 0
bct 7 5 0 0 0 0 1 0 0
bct 7 6 1 1 0 0 0 1 0
bct 7 7 1 0 0 0 0 0 0
bct 7 8 0 0 0 0 0 1 0
bct 7 9 0 0 0 0 0 0 0
bct 8 0 0 0 0 0 0 0 0
bct 8 1 0 0 0 0 1 0 0
bct 8 2 1 2 1 0 0 0 0
bct 8 3 0 0 0 0 0 0 0
bct 8 4 0 2 0 1 0 1 0
bct 8 5 0 0 0 0 0 0 0
bct 8 6 0 2 0 0 0 0 0
bct 8 7 0 0 0 0 0 0 0
bct 8 8 1 0 0 0 0 0 0
bct 8 9 0 0 0 0 0 0 0
bct 9 0 1 0 0 0 1 0 0
bct 9 1 0 0 1 0 0 0 0
bct 9 2 1 0 0 1 0 0 0
bct 9 3 2 0 1 0 1 1 0
bct 9 4 1 2 0 1 0 0 0
bct 9 5 1 0 0 0 0 0 0
bct 9 6 2 1 0 0 0 0 0
bct 9 7 1 0 0 0 0 0 0
bct 9 8 0 0 0 0 0 0 0
bct 9 9 0 0 0 0 0 0 0
/////////////////////
bct 0 0 0 0 0 0 0 0 0
bct 0 1 0 0 2 0 0 0 0
bct 0 2 0 1 0 0 0 0 0
bct 0 3 0 1 0 0 1 0 0
bct 0 4 0 1 0 0 0 0 0
bct 0 5 2 0 0 0 0 0 1
bct 0 6 0 0 0 0 0 0 0
bct 0 7 2 0 0 0 0 0 0
bct 0 8 1 0 0 0 0 0 0
bct 0 9 0 0 0 0 0 0 0
bct 1 0 0 0 0 0 0 0 2
bct 1 1 0 1 0 0 0 0 0
bct 1 2 0 0 1 0 0 0 0
bct 1 3 1 0 0 0 0 0 0
bct 1 4 1 1 0 0 0 0 0
bct 1 5 2 0 0 1 1 0 0
bct 1 6 0 1 1 0 0 0 0
bct 1 7 0 0 0 0 0 0 0
bct 1 8 2 1 0 0 0 0 0
bct 1 9 0 2 3 1 0 0 0
bct 2 0 1 0 0 0 0 0 0
bct 2 1 0 0 0 0 0 0 0
bct 2 2 0 0 0 0 0 0 0
bct 2 3 1 1 0 0 0 0 0
bct 2 4 2 1 1 0 0 0 0
bct 2 5 0 0 0 0 0 0 0
bct 2 6 1 1 0 0 0 0 0
bct 2 7 2 0 0 0 0 0 0
bct 2 8 0 0 0 0 0 0 0
bct 2 9 0 0 0 0 0 0 0
bct 3 0 0 1 0 0 0 0 0
bct 3 1 0 0 0 0 0 0 0
bct 3 2 1 0 0 0 0 0 1
bct 3 3 0 0 0 0 0 0 0
bct 3 4 0 0 0 0 0 0 0
bct 3 5 0 0 0 0 0 0 0
bct 3 6 0 0 0 0 0 0 0
bct 3 7 0 0 0 0 0 1 0
bct 3 8 1 0 0 0 0 0 0
bct 3 9 1 0 0 0 0 0 0
bct 4 0 0 0 0 0 0 0 0
bct 4 1 1 0 0 0 0 0 0
bct 4 2 1 0 0 0 0 0 0
bct 4 3 0 1 0 0 0 0 0
bct 4 4 1 1 0 0 0 0 0
bct 4 5 0 0 1 0 0 0 0
bct 4 6 0 0 0 0 0 0 0
bct 4 7 2 0 0 0 1 0 0
bct 4 8 1 0 0 0 0 0 0
bct 4 9 0 1 0 0 1 0 0
bct 5 0 2 0 0 0 0 0 1
bct 5 1 0 0 0 0 0 0 0
bct 5 2 0 0 0 0 0 1 0
bct 5 3 0 1 0 1 0 0 0
bct 5 4 0 0 0 0 0 0 0
bct 5 5 0 0 0 0 0 0 0
bct 5 6 0 0 0 1 0 0 0
bct 5 7 0 0 0 0 0 0 0
bct 5 8 0 0 0 1 0 0 0
bct 5 9 1 0 0 0 0 0 0
bct 6 0 0 0 1 0 0 0 0
bct 6 1 1 0 0 0 0 0 0
bct 6 2 1 0 0 0 0 1 0
bct 6 3 0 0 0 0 0 0 0
bct 6 4 1 0 0 0 0 1 0
bct 6 5 0 0 0 0 0 0 0
bct 6 6 1 0 0 0 0 0 0
bct 6 7 0 0 0 2 0 0 0
bct 6 8 0 1 1 0 1 0 0
bct 6 9 0 0 0 0 0 0 0
bct 7 0 1 0 0 0 0 0 0
bct 7 1 0 0 0 0 0 0 0
bct 7 2 0 1 1 0 0 0 0
bct 7 3 0 0 0 0 0 0 0
bct 7 4 2 0 0 0 1 0 0
bct 7 5 0 0 0 0 1 0 0
bct 7 6 1 1 0 0 0 1 0
bct 7 7 1 0 0 0 0 0 0
bct 7 8 0 0 0 0 0 1 0
bct 7 9 0 0 0 0 0 0 0
bct 8 0 0 0 0 0 0 0 0
bct 8 1 0 0 0 0 1 0 0
bct 8 2 1 2 1 0 0 0 0
bct 8 3 0 0 0 0 0 0 0
bct 8 4 0 2 0 1 0 1 0
bct 8 5 0 0 0 0 0 0 0
bct 8 6 0 2 0 0 0 0 0
bct 8 7 0 0 0 0 0 0 0
bct 8 8 1 0 0 0 0 0 0
bct 8 9 0 0 0 0 0 0 0
bct 9 0 1 0 0 0 1 0 0
bct 9 1 0 0 1 0 0 0 0
bct 9 2 1 0 0 1 0 0 0
bct 9 3 2 0 1 0 1 1 0
bct 9 4 1 2 0 1 0 0 0
bct 9 5 1 0 0 0 0 0 0
bct 9 6 2 1 0 0 0 0 0
bct 9 7 1 1 0 0 0 0 0
bct 9 8 0 0 0 0 0 0 0
bct 9 9 0 0 0 0 0 0 0
^C